Лемма 	часть
китайский	a
каменный	a
капризный	a
карибский	a
ранний	a
разумный	a
квадратный	a
киевский	a
разный	a
различный	a
реальный	a
разговорный	a
прошлый	a
классный	a
клевый	a
радостный	a
рад	a
равный	a
равнодушный	a
приличный	a
мобильный	a
красивый	a
красный	a
крашеный	a
приставной	a
крепкий	a
кривой	a
кругленький	a
круглый	a
рабочий	a
прикольный	a
крупный	a
крутой	a
крытый	a
приемный	a
приятный	a
редкий	a
региональный	a
меньший	a
популярный	a
мамин	a
понятный	a
массовый	a
культурный	a
медицинский	a
международный	a
мелкий	a
польский	a
малюсенький	a
местный	a
полосатый	a
металлический	a
полный	a
миленький	a
полезный	a
милый	a
мировой	a
любезный	a
книжный	a
пьяный	a
пушкинский	a
путный	a
пустой	a
психологический	a
прямой	a
классический	a
крайний	a
любимый	a
любопытный	a
последний	a
порядочный	a
майский	a
португальский	a
маленький	a
малый	a
особенный	a
ответный	a
определенный	a
опытный	a
острый	a
оранжевый	a
осторожный	a
оригинальный	a
орловский	a
особый	a
ответственный	a
основной	a
отдельный	a
нерусский	a
несчастный	a
передний	a
неудобный	a
нехороший	a
нижний	a
отличный	a
мутный	a
отрицательный	a
обычный	a
обязанный	a
огромный	a
одесский	a
одетый	a
одинаковый	a
одинокий	a
низкий	a
однокомнатный	a
открытый	a
одноместный	a
отечественный	a
октябрьский	a
нереальный	a
опасный	a
оперный	a
противный	a
офигенный	a
общественный	a
общий	a
отстойный	a
нужный	a
коммерческий	a
проходной	a
коммунальный	a
профессиональный	a
официальный	a
протертый	a
простой	a
компьютерный	a
конкретный	a
контрольный	a
прозрачный	a
коричневый	a
короткий	a
папин	a
новенький	a
педагогический	a
новый	a
нормальный	a
носатый	a
ночной	a
параллельный	a
обыкновенный	a
младший	a
обалденный	a
обаятельный	a
обеденный	a
очередной	a
очаровательный	a
образованный	a
обратный	a
охранный	a
больной	a
влюбленный	a
хороший	a
шикарный	a
вкусненький	a
больничный	a
вечерний	a
бурный	a
холодный	a
вечный	a
храбрый	a
вкусный	a
умный	a
широкий	a
хорошенький	a
чкаловский	a
элементарный	a
эмоциональный	a
активный	a
взрослый	a
будущий	a
французский	a
школьный	a
боковой	a
шоколадный	a
фруктовый	a
химический	a
юридический	a
виноватый	a
безумный	a
ясненький	a
юный	a
видный	a
хитрый	a
худенький	a
финский	a
адекватный	a
хреновый	a
чудный	a
человеческий	a
белорусский	a
белый	a
чуткий	a
четкий	a
бедненький	a
учебный	a
черный	a
чужой	a
верный	a
важный	a
чертов	a
экономический	a
великолепный	a
чудесный	a
актуальный	a
биологический	a
ужасный	a
васильевский	a
электрический	a
честный	a
яркий	a
узкий	a
чистый	a
черненький	a
великий	a
беременный	a
армянский	a
фаршированный	a
электронный	a
беленький	a
бешеный	a
актерский	a
бесплатный	a
бедный	a
фантастический	a
постоянный	a
летний	a
поэтический	a
пошехонский	a
почтовый	a
лингвистический	a
похожий	a
литературный	a
личный	a
лишний	a
правильный	a
посторонний	a
лучший	a
ленинский	a
веселый	a
философский	a
целый	a
шутливый	a
бабушкин	a
предыдущий	a
математический	a
купеческий	a
курский	a
курсовой	a
лабораторный	a
ладненький	a
прелестный	a
лазерный	a
прекрасный	a
языковой	a
ласковый	a
левый	a
легкий	a
ленинградский	a
практический	a
лысый	a
правый	a
лесной	a
внимательный	a
ясный	a
чайный	a
внутренний	a
американский	a
бледный	a
блестящий	a
верхний	a
ближайший	a
близкий	a
быстрый	a
утренний	a
бывший	a
центральный	a
физический	a
хозяйственный	a
больший	a
японский	a
большой	a
божий	a
английский	a
богатый	a
благодарный	a
цветной	a
шерстяной	a
бодрый	a
внешний	a
боевой	a
желтый	a
худой	a
художественный	a
ядовитый	a
финансовый	a
частый	a
частный	a
благополучный	a
благородный	a
свободный	a
семейный	a
сельскохозяйственный	a
седой	a
сегодняшний	a
северный	a
святой	a
связанный	a
своеобразный	a
здоровый	a
западный	a
игровой	a
зимний	a
светлый	a
светленький	a
злой	a
знакомый	a
свежий	a
знаменитый	a
испанский	a
иностранный	a
родной	a
интеллектуальный	a
интеллигентный	a
родительский	a
интересненький	a
ровный	a
интересный	a
искусственный	a
свадебный	a
исторический	a
итальянский	a
рекламный	a
резной	a
розовый	a
серенький	a
серебряный	a
заочный	a
гордый	a
глухой	a
теоретический	a
темный	a
долгий	a
телефонный	a
голодный	a
голубой	a
голый	a
театральный	a
глупый	a
горный	a
тверской	a
твердый	a
городской	a
горький	a
горьковский	a
горячий	a
талантливый	a
газовый	a
золотистый	a
золотой	a
саратовский	a
самостоятельный	a
зубной	a
самовлюбленный	a
зеленый	a
толстый	a
занятый	a
тихий	a
типичный	a
генеральный	a
гениальный	a
технический	a
главный	a
глубокий	a
теплый	a
серый	a
забавный	a
заграничный	a
задний	a
синий	a
симпатичный	a
сильный	a
закрытый	a
замечательный	a
серьезный	a
жуткий	a
скучный	a
должен	a
соседний	a
домашний	a
дополнительный	a
дорогой	a
соответствующий	a
дорожный	a
следующий	a
служебный	a
женатый	a
сложный	a
женский	a
жесткий	a
живой	a
сливочный	a
слепой	a
драматический	a
жизненный	a
жирный	a
сладкий	a
слабый	a
удобный	a
скромный	a
журнальный	a
скорый	a
известный	a
смелый	a
слышный	a
железный	a
современный	a
садовый	a
идеальный	a
избыточный	a
рыжий	a
рыбный	a
жаркий	a
русский	a
изумительный	a
импортный	a
ростовский	a
индивидуальный	a
российский	a
романтичный	a
индийский	a
духовный	a
солнечный	a
соленый	a
древний	a
дружный	a
дурацкий	a
согласный	a
желтенький	a
советский	a
натуральный	a
собственный	a
душевный	a
еврейский	a
собачий	a
единственный	a
естественный	a
смешной	a
жареный	a
неизвестный	a
невероятный	a
невкусный	a
невозможный	a
письменный	a
недовольный	a
недорогой	a
нежный	a
незнакомый	a
пешеходный	a
неважный	a
резкий	a
некрасивый	a
печатный	a
петроградский	a
петербургский	a
немецкий	a
ненормальный	a
необходимый	a
странный	a
грязный	a
сумасшедший	a
студенческий	a
далекий	a
строгий	a
дальний	a
страшный	a
страховой	a
дачный	a
необычный	a
столовый	a
двойной	a
двоюродный	a
двухкомнатный	a
супер	a
начальный	a
платный	a
небольшой	a
надземный	a
московский	a
мужской	a
музыкальный	a
национальный	a
подобный	a
мягкий	a
подземный	a
мясной	a
наглый	a
морской	a
налоговый	a
народный	a
нарядный	a
настоящий	a
наташкин	a
плохой	a
научный	a
голливудский	a
мокрый	a
неплохой	a
непонятный	a
неправильный	a
неприятный	a
неразборчивый	a
нервный	a
неинтересный	a
модный	a
военный	a
поздний	a
молодежный	a
молоденький	a
молодой	a
пожилой	a
молочный	a
мороженый	a
подходящий	a
тонкий	a
выборгский	a
выгодный	a
выпускной	a
точный	a
высокий	a
высший	a
выходной	a
торговый	a
вязаный	a
вчерашний	a
трудный	a
двухместный	a
двухэтажный	a
девичий	a
стиральный	a
стеклянный	a
старый	a
старший	a
тяжелый	a
двухлетний	a
удивительный	a
удачный	a
возможный	a
уголовный	a
угодный	a
угловой	a
уверенный	a
восточный	a
суперский	a
турецкий	a
тупой	a
вредный	a
трудовой	a
тоненький	a
троюродный	a
трехлитровый	a
треугольный	a
грешный	a
социальный	a
докторский	a
сотовый	a
дешевый	a
готовый	a
сырой	a
сырный	a
гражданский	a
греческий	a
деловой	a
грозный	a
громадный	a
громкий	a
счастливый	a
грузовой	a
сухой	a
грустный	a
старинный	a
добрый	a
довольный	a
стандартный	a
деревенский	a
деревянный	a
средний	a
детский	a
государственный	a
способный	a
спортивный	a
спокойный	a
сплошной	a
дипломный	a
специальный	a
длинный	a
дневной	a
дикий	a
холодно	adv
светло	adv
хоп	adv
сверху	adv
подробно	adv
больно	adv
значит	adv
значительно	adv
пожалуй	adv
подряд	adv
может	adv
реально	adv
кажется	adv
регулярно	adv
редко	adv
резко	adv
много	adv
пока	adv
целиком	adv
подозрительно	adv
можно	adv
далее	adv
однажды	adv
видно	adv
гораздо	adv
видимо	adv
обычно	adv
видать	adv
строго	adv
вовсе	adv
далеко	adv
во-первых	adv
шикарно	adv
дай-ка	adv
вообще-то	adv
вообще	adv
хорошо	adv
более	adv
более-менее	adv
известно	adv
рядом	adv
идеально	adv
зря	adv
заранее	adv
налево	adv
скажем	adv
намного	adv
наверное	adv
свободно	adv
больше	adv
здорово	adv
мягко	adv
великолепно	adv
сегодня	adv
наконец	adv
наверно	adv
мимо	adv
наверняка	adv
запросто	adv
наверх	adv
наверху	adv
навсегда	adv
навстречу	adv
заочно	adv
заодно	adv
замуж	adv
ровно	adv
интересно	adv
позавчера	adv
иногда	adv
молча	adv
моментально	adv
надолго	adv
заново	adv
серьезно	adv
замужем	adv
поздно	adv
надо	adv
замечательно	adv
сзади	adv
заметно	adv
босиком	adv
назад	adv
наизусть	adv
сильно	adv
накануне	adv
параллельно	adv
удобно	adv
вместе	adv
впервые	adv
окончательно	adv
скоро	adv
вначале	adv
все-все	adv
откровенно	adv
толком	adv
ок	adv
тоже	adv
внешне	adv
вперед	adv
абсолютно	adv
тяжело	adv
впереди	adv
опять	adv
вот-вот	adv
высоко	adv
впотьмах	adv
открыто	adv
явно	adv
средне	adv
опять-таки	adv
втроем	adv
внизу	adv
отдельно	adv
тихо	adv
вниз	adv
точно	adv
вовремя	adv
вернее	adv
очевидно	adv
вкусно	adv
одновременно	adv
вполне	adv
особенно	adv
тупо	adv
внимательно	adv
уж	adv
нужно	adv
вчера	adv
внутри	adv
главное	adv
счастливо	adv
громко	adv
ужасно	adv
грубо	adv
вряд	adv
удачно	adv
возможно	adv
обязательно	adv
отлично	adv
туда-обратно	adv
весело	adv
осторожно	adv
одинаково	adv
странно	adv
верно	adv
глубоко	adv
особо	adv
тепло	adv
говорят	adv
темно	adv
вероятно	adv
удивительно	adv
давным-давно	adv
давно	adv
также	adv
стыдно	adv
официально	adv
вроде	adv
вечно	adv
охота	adv
оригинально	adv
угодно	adv
страшно	adv
уже	adv
обратно	adv
вокруг	adv
во-вторых	adv
трудно	adv
обидно	adv
очень	adv
очень-очень	adv
супер	adv
немножко	adv
должно	adv
долго	adv
неправильно	adv
соответственно	adv
неприятно	adv
недолго	adv
неразборчиво	adv
достаточно	adv
периодически	adv
ненадолго	adv
дорого	adv
немножечко	adv
быстренько	adv
бывало	adv
немного	adv
несколько	adv
довольно	adv
спасибо	adv
нельзя	adv
действительно	adv
слышь	adv
еле	adv
нехорошо	adv
собственно	adv
душно	adv
дико	adv
недалеко	adv
недавно	adv
негде	adv
невозможно	adv
снова	adv
невкусно	adv
слышно	adv
снизу	adv
фактически	adv
быстро	adv
важно	adv
дома	adv
неплохо	adv
домой	adv
неохота	adv
непонятно	adv
непосредственно	adv
сразу	adv
жутко	adv
напротив	adv
завтра	adv
наоборот	adv
например	adv
направо	adv
еще	adv
смешно	adv
естественно	adv
небось	adv
насколько	adv
жарко	adv
жаль	adv
аккуратно	adv
неважно	adv
дешево	adv
вверх	adv
нечаянно	adv
жалко	adv
справа	adv
похоже	adv
эмоционально	adv
платно	adv
желательно	adv
случайно	adv
буквально	adv
сначала	adv
вдвоем	adv
срочно	adv
сложно	adv
вдруг	adv
нафиг	adv
примерно	adv
слишком	adv
плохо	adv
нормально	adv
слегка	adv
слева	adv
настолько	adv
слабо	adv
скучно	adv
по-английски	adv
круто	adv
легко	adv
безумно	adv
честно	adv
практически	adv
после	adv
кстати	adv
безусловно	adv
чисто	adv
правильно	adv
правда	adv
приблизительно	adv
прикольно	adv
кругом	adv
по-любому	adv
чуть-чуть	adv
равно	adv
часто	adv
по-настоящему	adv
раз	adv
клево	adv
классно	adv
потихоньку	adv
почти	adv
крепко	adv
бегом	adv
красиво	adv
приятно	adv
по-хорошему	adv
бесплатно	adv
прилично	adv
потрясающе	adv
лично	adv
неудобно	adv
коротко	adv
постоянно	adv
бесполезно	adv
постепенно	adv
послезавтра	adv
лень	adv
прекрасно	adv
ладно	adv
четко	adv
совсем	adv
ясно	adv
пора	adv
прямо	adv
пополам	adv
понятно	adv
спокойно	adv
щас	adv
несмотря	adv
шутливо	adv
неинтересно	adv
чуть	adv
нет	adv
сперва	adv
специально	adv
нет-нет	adv
нету	adv
пешком	adv
неизвестно	adv
совершенно	adv
некуда	adv
медленно	adv
мало	adv
менее	adv
близко	adv
разумеется	adv
ярко	adv
рано	adv
полностью	adv
полно	adv
полезно	adv
маленько	adv
конкретно	adv
просто	adv
конечно	adv
затем	adv
чего-чего	adv
прохладно	adv
противно	adv
против	adv
комплект	s
билет	s
комплимент	s
композитор	s
компот	s
компьютер	s
бизнес	s
библиотека	s
комсомолка	s
конверт	s
граф	s
господь	s
взгляд	s
гостиница	s
гость	s
вещь	s
конфетка	s
государство	s
комментарий	s
концепция	s
концерт	s
конь	s
коньяк	s
кооператив	s
комплекс	s
комедия	s
комиссия	s
борьба	s
комментатор	s
коммуникация	s
коммунист	s
комната	s
биология	s
комп	s
компания	s
ветер	s
голова	s
голод	s
вилка	s
виза	s
голос	s
гора	s
горе	s
горло	s
вина	s
вид	s
город	s
городок	s
взрослый	s
горох	s
горошек	s
белка	s
горшок	s
гречка	s
градус	s
вечерок	s
грамм	s
граница	s
господин	s
график	s
грех	s
вечеринка	s
гот	s
вечер	s
гриб	s
гриль	s
гроб	s
ветка	s
ветеран	s
видео	s
гол	s
колхоз	s
колесо	s
колечко	s
количество	s
колледж	s
коктейль	s
коллекция	s
колонка	s
колонна	s
колесико	s
кольцо	s
коляска	s
команда	s
командир	s
командировка	s
комар	s
книжка	s
клей	s
кувшин	s
жанр	s
крыло	s
крыльцо	s
крыса	s
крыша	s
крышка	s
крючок	s
куб	s
клетка	s
кукла	s
коллектив	s
колбаса	s
колбаска	s
колготки	s
коленка	s
колено	s
конспект	s
благо	s
козел	s
контора	s
конец	s
конка	s
конкурс	s
консерватория	s
консервы	s
коза	s
конституция	s
конструктор	s
консультация	s
контакт	s
конек	s
контракт	s
контроль	s
конференция	s
комбикорм	s
клиент	s
клип	s
клоун	s
клуб	s
клубника	s
ключ	s
книга	s
книжечка	s
конфета	s
кнопка	s
кнопочка	s
ковер	s
коврик	s
благодарность	s
код	s
кожа	s
гильдия	s
ворота	s
воротник	s
воскресенье	s
воспитание	s
глаз	s
герменевтика	s
героиня	s
герой	s
ворот	s
гимназия	s
гимнастика	s
гитара	s
глава	s
главное	s
вишня	s
география	s
глазок	s
возраст	s
водичка	s
водка	s
водолазка	s
водитель	s
военный	s
воздух	s
вода	s
возможность	s
глобализация	s
война	s
выражение	s
волк	s
волна	s
волос	s
воля	s
вопрос	s
гарантия	s
газета	s
газетка	s
девятка	s
власть	s
галоша	s
галстук	s
галька	s
гараж	s
газ	s
геморрой	s
генерал	s
гений	s
вкус	s
букет	s
ерунда	s
бумажка	s
содержание	s
влияние	s
глубина	s
витрина	s
глупость	s
витамин	s
вирус	s
виноград	s
говно	s
год	s
вокзал	s
высота	s
выставка	s
выступление	s
выход	s
выходной	s
гад	s
гадость	s
ветвь	s
дебил	s
дева	s
девица	s
девка	s
девочка	s
девушка	s
девчонка	s
вес	s
велосипед	s
громкость	s
грохот	s
грош	s
грудь	s
грузин	s
весна	s
группа	s
груша	s
движение	s
вздох	s
госпиталь	s
дворник	s
дата	s
дача	s
версия	s
дверь	s
двигатель	s
грядка	s
двойка	s
вера	s
двор	s
дворец	s
данные	s
веник	s
вена	s
вуз	s
враг	s
врач	s
внучка	s
время	s
встреча	s
внук	s
воспоминание	s
второе	s
вобла	s
вход	s
выбор	s
внимание	s
вывод	s
выезд	s
вызов	s
выпускной	s
внешность	s
даль	s
вино	s
грязь	s
губа	s
губерния	s
гудрон	s
гульден	s
гусь	s
давление	s
взнос	s
верх	s
дама	s
вторник	s
восток	s
восторг	s
восьмая	s
впечатление	s
карточка	s
класс	s
классика	s
блат	s
кассир	s
карман	s
карта	s
картина	s
картинка	s
клан	s
картошечка	s
картошка	s
карьера	s
касса	s
кассета	s
интернет	s
кастрюля	s
каталог	s
киоск	s
кетчуп	s
кефир	s
кило	s
килограмм	s
километр	s
килька	s
кино	s
кинотеатр	s
категория	s
квадрат	s
кирпич	s
кисель	s
кислород	s
китаец	s
блеск	s
кладбище	s
змея	s
здоровье	s
больной	s
заяц	s
земля	s
зеркало	s
зима	s
зло	s
злодей	s
большевик	s
знак	s
знакомая	s
знакомство	s
знакомый	s
заработок	s
заочник	s
борщ	s
запад	s
звание	s
каток	s
кафе	s
кафедра	s
качество	s
каша	s
кашель	s
кашка	s
зелень	s
квартира	s
звезда	s
звездочка	s
зверь	s
звон	s
звонок	s
звук	s
здание	s
каблук	s
сливки	s
словарь	s
слово	s
сложность	s
слой	s
служба	s
каникулы	s
блюдо	s
слеза	s
кавычка	s
кадр	s
блондинка	s
кайф	s
калитка	s
блокнот	s
камень	s
камера	s
скоба	s
слава	s
сказка	s
скала	s
скандал	s
сканер	s
скидка	s
склад	s
склероз	s
канал	s
сковородка	s
скорость	s
скотина	s
привет	s
сладкое	s
след	s
следователь	s
..лядь	s
исключение	s
искра	s
искусство	s
бобер	s
исполнение	s
блин	s
истерика	s
историк	s
ирония	s
история	s
источник	s
итог	s
июль	s
июнь	s
йогурт	s
йод	s
кипяток	s
карась	s
кабинет	s
каньон	s
капелька	s
капельница	s
капитан	s
блок	s
капуста	s
карамель	s
борода	s
каратэ	s
кардиограмма	s
исследование	s
интонация	s
инфаркт	s
информант	s
информация	s
кресло	s
корабль	s
корень	s
корзина	s
коридор	s
коробка	s
коробочка	s
корова	s
королева	s
кора	s
корпус	s
коса	s
косметика	s
космос	s
костер	s
косточка	s
кость	s
костюм	s
креатив	s
кран	s
красавец	s
беседа	s
котенок	s
краска	s
красота	s
красотка	s
берег	s
косяк	s
кредит	s
крем	s
крендель	s
крепдешин	s
бензин	s
король	s
копия	s
крестная	s
лавочка	s
лагерь	s
лад	s
ладонь	s
лазанье	s
безобразие	s
кружка	s
крест	s
лавка	s
крик	s
кровать	s
кровь	s
кролик	s
кроссовка	s
кроссовок	s
круг	s
белье	s
курс	s
кот	s
куст	s
кулич	s
культура	s
купальник	s
купец	s
куратор	s
курица	s
край	s
куртка	s
кусок	s
кусочек	s
кулак	s
кухня	s
куча	s
безопасность	s
инициатива	s
бой	s
икра	s
болванка	s
имя	s
индеец	s
бокал	s
инет	s
инженер	s
заявление	s
бок	s
иностранец	s
изображение	s
инспектор	s
институт	s
инструктор	s
инструкция	s
инструмент	s
зарплата	s
запас	s
запах	s
записка	s
запись	s
бомба	s
запятая	s
знание	s
зараза	s
интеллект	s
зарядка	s
засада	s
заседание	s
большинство	s
зачет	s
защита	s
заявка	s
изменение	s
игрушка	s
боль	s
идея	s
идиот	s
болото	s
болезнь	s
издательство	s
излучение	s
игра	s
красавица	s
котлета	s
кофе	s
кофта	s
кофточка	s
кошечка	s
кошка	s
кошмар	s
зонт	s
интервью	s
интерес	s
бог	s
интернат	s
зуб	s
значение	s
значок	s
зона	s
копейка	s
больница	s
зонтик	s
зоопарк	s
зрение	s
зритель	s
больная	s
бланк	s
наличие	s
алкоголь	s
неправда	s
альбом	s
адрес	s
наполнитель	s
овощи	s
автор	s
обязанность	s
нерв	s
налог	s
аудитория	s
намек	s
напиток	s
название	s
направление	s
обычай	s
наркоман	s
ноябрь	s
норма	s
ноутбук	s
аккорд	s
нос	s
академия	s
носок	s
обход	s
ночь	s
наркотик	s
нитка	s
ник	s
низ	s
акт	s
актер	s
нянька	s
няня	s
актриса	s
начало	s
огонек	s
овца	s
надпись	s
общение	s
наушник	s
общество	s
национальность	s
артист	s
огонь	s
начальник	s
адвокат	s
начальство	s
агентство	s
армия	s
общежитие	s
небо	s
арка	s
автомобиль	s
народ	s
аська	s
лайка	s
одежда	s
автобус	s
набор	s
автомат	s
одеяло	s
номер	s
нагрузка	s
автоответчик	s
надежда	s
ассортимент	s
огурчик	s
огурец	s
огород	s
ангел	s
милиционер	s
балкон	s
микрофон	s
микроволновка	s
мешок	s
мечта	s
меценат	s
механик	s
милиция	s
анекдот	s
англичанин	s
образец	s
образ	s
оборот	s
обои	s
обогреватель	s
немец	s
мобильник	s
миска	s
минимум	s
оперативник	s
базар	s
мнение	s
опера	s
мобила	s
абзац	s
анчоус	s
набережная	s
миндаль	s
мимоза	s
балалайка	s
оплата	s
балет	s
миллион	s
новость	s
обстановка	s
неделька	s
неделя	s
апостол	s
апельсин	s
образование	s
недостаток	s
ноль	s
американец	s
аккумулятор	s
нога	s
ноготь	s
нож	s
ножик	s
ножка	s
ножницы	s
новое	s
аптека	s
анализ	s
обморок	s
обмен	s
область	s
обида	s
администратор	s
обед	s
негр	s
общее	s
обучение	s
невеста	s
обувь	s
апрель	s
обстоятельство	s
аппетит	s
аппарат	s
баян	s
основа	s
лампочка	s
основание	s
лиса	s
литр	s
башня	s
литература	s
орган	s
лапа	s
организация	s
литератор	s
организм	s
листочек	s
орден	s
лист	s
ложка	s
линолеум	s
оригинал	s
лестница	s
оружие	s
бедняга	s
лес	s
осень	s
бедро	s
лен	s
лекция	s
линия	s
легкое	s
легенда	s
лев	s
латынь	s
лапша	s
лапочка	s
лапка	s
матрас	s
маршрут	s
мамочка	s
маршрутка	s
масленица	s
масло	s
масса	s
определение	s
массаж	s
мастер	s
маманя	s
мамаша	s
материал	s
манера	s
маньяк	s
мат	s
математика	s
сода	s
мать	s
линза	s
линейка	s
лингвист	s
лимон	s
беда	s
лидер	s
лига	s
орех	s
оркестр	s
марка	s
март	s
матрица	s
матч	s
мастерская	s
барабан	s
мамка	s
луна	s
население	s
лох	s
батон	s
любовь	s
любовник	s
любитель	s
батончик	s
лыжа	s
агент	s
лук	s
лужа	s
башка	s
лошадь	s
батарея	s
лось	s
лопата	s
лом	s
аспирантура	s
аренда	s
общага	s
монитор	s
наука	s
объект	s
архитектор	s
натура	s
архитектура	s
машина	s
настройка	s
объем	s
настроение	s
аспирин	s
объявление	s
объяснение	s
насморк	s
май	s
макет	s
макдональдс	s
лифт	s
бас	s
бассейн	s
майонез	s
майка	s
батарейка	s
максимум	s
магнитофон	s
магазинчик	s
магазин	s
люстра	s
люд	s
лекарство	s
летчик	s
лето	s
мама	s
ложечка	s
лодка	s
лоб	s
личность	s
личинка	s
лицо	s
лифчик	s
макароны	s
бакс	s
маляр	s
барахло	s
опыт	s
мальчишка	s
мальчик	s
малыш	s
малина	s
варенье	s
диалект	s
диалог	s
диван	s
диета	s
вата	s
диктофон	s
диплом	s
детство	s
диагноз	s
директор	s
дирижер	s
диск	s
дискета	s
дискотека	s
диссертация	s
длина	s
ванная	s
жуть	s
жук	s
бригада	s
бред	s
дух	s
журнал	s
журналистика	s
бревно	s
брат	s
дневник	s
браслет	s
забор	s
заведение	s
зависимость	s
завод	s
вариант	s
деятельность	s
джинсы	s
доход	s
дерьмо	s
десятка	s
десяток	s
деталь	s
детка	s
дружба	s
доска	s
доставка	s
дерево	s
дочка	s
дочь	s
драка	s
дракон	s
бык	s
дрова	s
друг	s
дорожка	s
деканат	s
день	s
век	s
дед	s
дедушка	s
дежурный	s
действие	s
декабрь	s
декан	s
жопа	s
дело	s
ведро	s
ванна	s
деньги	s
депрессия	s
вдох	s
деревня	s
буфет	s
живот	s
дэ	s
бухгалтер	s
духи	s
духовка	s
буханка	s
душ	s
душа	s
будка	s
дырка	s
дырочка	s
дыхание	s
животное	s
дядька	s
дядя	s
еврей	s
еврейка	s
буква	s
бумага	s
бульон	s
бульвар	s
булочка	s
желание	s
булка	s
железо	s
елка	s
бутылочка	s
желудок	s
жена	s
жених	s
будущее	s
женщина	s
жест	s
жесть	s
замок	s
боулинг	s
ботинок	s
заказ	s
закон	s
босоножка	s
зал	s
зам	s
замечание	s
завтрак	s
занятие	s
жулик	s
жидкость	s
будильник	s
брюки	s
жизнь	s
жир	s
бровь	s
брак	s
бутылка	s
евро	s
еда	s
бутерброд	s
ежик	s
зайчик	s
завуч	s
загадка	s
дрянь	s
загс	s
зад	s
задание	s
задача	s
бочка	s
задница	s
зажигалка	s
мотоцикл	s
музыкант	s
бабочка	s
музыка	s
музей	s
мужчина	s
озеро	s
мужик	s
муж	s
мука	s
мотор	s
мост	s
месяц	s
банк	s
меню	s
мера	s
мероприятие	s
мертвый	s
мясорубка	s
мыло	s
мысль	s
мышка	s
мышца	s
муть	s
баба	s
аэропорт	s
мясо	s
бандит	s
август	s
мяч	s
мячик	s
база	s
мусор	s
муравейник	s
мультик	s
банка	s
бар	s
оппонент	s
механизм	s
медсестра	s
баня	s
баночка	s
мелодия	s
мелочь	s
медик	s
менеджер	s
младенец	s
минус	s
минута	s
минутка	s
минуточка	s
мир	s
операция	s
метро	s
бандероль	s
место	s
мент	s
банан	s
метод	s
методика	s
метр	s
баллон	s
мучение	s
мех	s
медосмотр	s
машинка	s
мебель	s
мед	s
медаль	s
медведь	s
должность	s
дождь	s
доказательство	s
доклад	s
клиника	s
вал	s
документ	s
долг	s
ваза	s
валенок	s
доллар	s
дом	s
вагон	s
домик	s
дорога	s
окончание	s
октябрь	s
момент	s
бухгалтерия	s
дуб	s
дума	s
дура	s
дурак	s
дурачок	s
дурдом	s
дурочка	s
дурь	s
окраина	s
доктор	s
дно	s
добро	s
доверенность	s
вампир	s
договор	s
дождик	s
молоток	s
мозг	s
бабушка	s
бабуля	s
ом	s
молодежь	s
окно	s
молодость	s
молоко	s
модель	s
олимпиада	s
молочко	s
окунь	s
абонемент	s
мышь	s
авария	s
бабка	s
муха	s
мороженое	s
монастырь	s
окошко	s
монстр	s
морда	s
море	s
молчание	s
морковка	s
морковь	s
жара	s
мороз	s
морозилка	s
бабулька	s
москвич	s
молодец	s
могила	s
мода	s
фестиваль	s
урок	s
урод	s
уровень	s
урка	s
упражнение	s
управление	s
упаковка	s
унитаз	s
университет	s
универ	s
умничка	s
ус	s
фигня	s
фига	s
фиг	s
трава	s
февраль	s
фасон	s
фара	s
фантастика	s
фанат	s
фамилия	s
факультет	s
учеба	s
факс	s
файл	s
фабрика	s
ущелье	s
ушко	s
учительница	s
учитель	s
сыр	s
тариф	s
тарелка	s
таракан	s
тапочка	s
тапка	s
танк	s
счетчик	s
талон	s
талант	s
такси	s
тайм	s
тайга	s
тазик	s
таблетка	s
сюжет	s
училище	s
сын	s
съезд	s
танец	s
участок	s
участник	s
участие	s
уход	s
ухо	s
уха	s
утро	s
устройство	s
установка	s
успех	s
условие	s
туфля	s
уксус	s
украшение	s
укол	s
узбек	s
ужин	s
ужас	s
удовольствие	s
удивление	s
туберкулез	s
удар	s
угол	s
уборка	s
убийство	s
тюль	s
тысяча	s
улица	s
тусовка	s
турникет	s
тумбочка	s
тумба	s
удача	s
понятой	s
поп	s
попа	s
попытка	s
первое	s
пора	s
пепельница	s
пень	s
пенсия	s
пенсионер	s
умница	s
ученый	s
ученик	s
учебник	s
факт	s
туалет	s
тряпка	s
трусы	s
трудность	s
труд	s
трубочка	s
трубка	s
труба	s
троллейбус	s
тройка	s
троица	s
татарин	s
третья	s
треть	s
тренировка	s
тренинг	s
тренер	s
транспорт	s
трамвай	s
трактор	s
традиция	s
трагедия	s
травка	s
треугольник	s
ум	s
улыбка	s
шарик	s
шов	s
шляпа	s
шкурка	s
шкура	s
шар	s
школа	s
шкаф	s
ширина	s
шея	s
шерсть	s
шейпинг	s
шашлык	s
шашка	s
шахматы	s
шарф	s
шок	s
школьник	s
тетрадь	s
тетрадка	s
тетка	s
тесто	s
тест	s
территория	s
терраска	s
терраса	s
терпение	s
термос	s
термин	s
фигура	s
теория	s
тень	s
число	s
шапочка	s
шапка	s
шанс	s
шампунь	s
шампанское	s
шаман	s
шаг	s
чушь	s
чурка	s
чулок	s
чувство	s
штанишки	s
чтение	s
член	s
чистка	s
температура	s
четверть	s
четвертая	s
четверка	s
четверг	s
честь	s
чеснок	s
чертеж	s
чувак	s
штамп	s
шофер	s
шоу	s
шоссе	s
шоколадка	s
шоколад	s
сумка	s
тетя	s
ток	s
счет	s
счастье	s
сцена	s
схема	s
существование	s
существо	s
сухарь	s
суть	s
сутки	s
супчик	s
суп	s
телевидение	s
сумма	s
техник	s
сука	s
судья	s
судьба	s
суд	s
суббота	s
ступенька	s
стул	s
стук	s
студия	s
сумочка	s
текст	s
театр	s
творчество	s
творог	s
торговля	s
темп	s
темнота	s
тема	s
тело	s
телик	s
телефон	s
телеграмма	s
телевизор	s
тепло	s
точка	s
тост	s
тоска	s
тортик	s
торт	s
тормоз	s
пение	s
тон	s
том	s
толпа	s
толк	s
тетушка	s
товарищ	s
товар	s
ткань	s
тишина	s
тип	s
течение	s
технология	s
техникум	s
техника	s
пивко	s
поликлиника	s
полис	s
полицай	s
полк	s
полка	s
полкило	s
перерыв	s
пирожок	s
пирожное	s
пирог	s
..издец	s
пидор	s
поза	s
пиджак	s
пиво	s
полигон	s
позвоночник	s
пешеход	s
перчатка	s
печь	s
печка	s
показание	s
печенье	s
показатель	s
печень	s
печать	s
петрушка	s
песок	s
песня	s
песенка	s
пес	s
персонаж	s
пляж	s
плюс	s
подписка	s
площадь	s
площадка	s
плоскость	s
подпись	s
плитка	s
подробность	s
подросток	s
подруга	s
плита	s
победа	s
покой	s
перспектива	s
поиск	s
поколение	s
период	s
перец	s
переход	s
переулок	s
покупатель	s
пересказ	s
покупка	s
писатель	s
пол	s
полгода	s
полдень	s
поле	s
полет	s
прелесть	s
преподаватель	s
премия	s
прадед	s
правило	s
предел	s
право	s
отвертка	s
претензия	s
остров	s
остаток	s
остановка	s
правительство	s
предложение	s
президент	s
отопление	s
практика	s
предприятие	s
отзыв	s
отель	s
отдых	s
особенность	s
предприниматель	s
поход	s
представление	s
председатель	s
официант	s
прибыль	s
отец	s
основное	s
отделение	s
охота	s
отчет	s
отдел	s
отпуск	s
правда	s
пояс	s
отрывок	s
открытка	s
поэт	s
поэзия	s
отсутствие	s
оттенок	s
офицер	s
почта	s
отчество	s
почка	s
предмет	s
плечо	s
отъезд	s
предок	s
открытие	s
почва	s
отделка	s
офис	s
почтамт	s
ответ	s
праздник	s
ответственность	s
преподавание	s
препод	s
препарат	s
отношение	s
палатка	s
переводчик	s
понедельник	s
перевод	s
понимание	s
понт	s
пончик	s
переезд	s
пальчик	s
пальто	s
поставка	s
палочка	s
палка	s
поставщик	s
постановка	s
палец	s
передача	s
постель	s
палата	s
пауза	s
пакет	s
па	s
ощущение	s
ошибка	s
посуда	s
очки	s
очередь	s
оценка	s
посылка	s
пот	s
охрана	s
поток	s
положение	s
потолок	s
пединститут	s
педаль	s
поросенок	s
порошок	s
педагог	s
певец	s
портрет	s
портфель	s
пачка	s
порядок	s
пацан	s
пельмень	s
половина	s
половинка	s
пакетик	s
полоса	s
полотенце	s
перемена	s
полочка	s
полтинник	s
перекресток	s
полчаса	s
польза	s
понятие	s
помещение	s
помидор	s
помойка	s
помощник	s
помощь	s
письмо	s
платье	s
подушка	s
подход	s
платформа	s
подъезд	s
полковник	s
платочек	s
плата	s
поезд	s
поездка	s
план	s
плакат	s
пища	s
пицца	s
питание	s
плащ	s
пистолет	s
пожар	s
подъем	s
погода	s
подарок	s
подвал	s
повышение	s
подготовка	s
поворот	s
поддержка	s
повод	s
сволочь	s
поведение	s
поднос	s
пара	s
поселок	s
патрон	s
пасха	s
паста	s
пассажир	s
паспорт	s
партия	s
парта	s
парочка	s
посольство	s
паровоз	s
памятник	s
парикмахерская	s
парикмахер	s
парень	s
совпадение	s
пост	s
пар	s
папка	s
папаша	s
папа	s
пансион	s
панель	s
память	s
парк	s
подружка	s
пленка	s
племянница	s
племянник	s
плеер	s
пудель	s
спецкурс	s
специальность	s
специалист	s
спекулянт	s
спектакль	s
спасибо	s
спальня	s
союз	s
сочинение	s
спиртное	s
путешествие	s
путевка	s
пуск	s
пункт	s
пузо	s
спина	s
пуд	s
пуговица	s
пугач	s
публика	s
птичка	s
свечка	s
психология	s
психолог	s
психика	s
пряжка	s
пруд	s
прошлое	s
процесс	s
процент	s
проход	s
сознание	s
сосна	s
соска	s
соседка	s
сосед	s
стакан	s
соревнование	s
сообщение	s
сон	s
солянка	s
соль	s
солнышко	s
солнце	s
солдат	s
сокол	s
сок	s
профессор	s
сорт	s
стадион	s
срок	s
средство	s
среда	s
сравнение	s
справка	s
способность	s
способ	s
спорт	s
спор	s
список	s
сочетание	s
спирт	s
привычка	s
прическа	s
приступ	s
природа	s
принцип	s
принтер	s
пример	s
протокол	s
прикол	s
приключение	s
приказ	s
признак	s
приемник	s
прием	s
придурок	s
приглашение	s
причина	s
прививка	s
приветик	s
прима	s
просьба	s
пространство	s
проспект	s
просмотр	s
пропуск	s
промоутер	s
прокуратура	s
произношение	s
производство	s
произведение	s
проза	s
проверка	s
радио	s
профессия	s
птица	s
рамка	s
раковина	s
рак	s
район	s
рай	s
разрыв	s
разрешение	s
разница	s
размер	s
разговор	s
развитие	s
путь	s
радость	s
сосок	s
раввин	s
рабочий	s
работник	s
работа	s
пятно	s
пятница	s
пятерка	s
пьеса	s
пыль	s
раз	s
проблема	s
пробка	s
приятельница	s
приятель	s
система	s
сезон	s
север	s
ситуация	s
сдача	s
священник	s
связь	s
ящик	s
свобода	s
свитер	s
свинья	s
свидетельство	s
свидетель	s
свиданье	s
свидание	s
сеанс	s
секрет	s
сирота	s
синяк	s
сила	s
сиденье	s
сидение	s
сигнализация	s
сигарета	s
сеть	s
сетка	s
сестра	s
семечко	s
серпантин	s
серия	s
сериал	s
сережка	s
смех	s
юрист	s
совет	s
совесть	s
событие	s
собственность	s
собственник	s
собрание	s
собор	s
собеседование	s
слух	s
собака	s
сникерс	s
снег	s
смысл	s
смородина	s
середина	s
сметана	s
смесь	s
смерть	s
смена	s
случай	s
собачка	s
семестр	s
семейство	s
село	s
селедка	s
секция	s
секунда	s
секс	s
секретарь	s
страдание	s
студент	s
структура	s
строчка	s
стройка	s
строительство	s
стрижка	s
стрелочка	s
стрелка	s
страховка	s
страх	s
стратегия	s
стол	s
страничка	s
страница	s
страна	s
стекло	s
стоянка	s
сторона	s
столовка	s
столовая	s
столица	s
столик	s
столб	s
страсть	s
соус	s
сотрудник	s
сотня	s
сотка	s
состояние	s
состав	s
степень	s
сердце	s
сервис	s
сентябрь	s
сено	s
семья	s
семинар	s
сессия	s
стоимость	s
стихотворение	s
стихи	s
стих	s
стирка	s
стипендия	s
стиль	s
стереотип	s
эра	s
стенка	s
стена	s
сожаление	s
стационар	s
статья	s
стать	s
статус	s
старье	s
старушка	s
старуха	s
старость	s
старик	s
станция	s
стаканчик	s
философия	s
фотоаппарат	s
фотка	s
форум	s
форточка	s
формат	s
форма	s
фон	s
фокус	s
флаг	s
фишка	s
холодильник	s
финн	s
фильтр	s
фильм	s
филфак	s
фотография	s
философ	s
филолог	s
филиал	s
физкультура	s
физиономия	s
физика	s
фирма	s
холод	s
хоккей	s
хозяйство	s
хозяйка	s
хозяин	s
ход	s
хлебушек	s
хлеб	s
человечек	s
хрень	s
хрен	s
храм	s
хохот	s
хор	s
цветок	s
черт	s
черника	s
черная	s
чердак	s
чемпионат	s
чемпион	s
чемодан	s
челюсть	s
человечество	s
хирург	s
человек	s
цифра	s
челка	s
чек	s
чашка	s
часы	s
часть	s
часик	s
час	s
чайник	s
чайка	s
чай	s
чаек	s
чело	s
ягода	s
шум	s
шуба	s
штучка	s
штука	s
штраф	s
штора	s
штаны	s
щука	s
японец	s
январь	s
яма	s
яйцо	s
яичко	s
языкознание	s
язык	s
шутка	s
явление	s
яблочко	s
яблоко	s
эпоха	s
юр	s
юность	s
юмор	s
юг	s
юбка	s
юбилей	s
эффект	s
этап	s
этаж	s
эскимо	s
проезд	s
энергия	s
химия	s
херня	s
фраза	s
хвостик	s
хвост	s
характеристика	s
характер	s
халат	s
футболка	s
футбол	s
функция	s
фрукт	s
фронт	s
француз	s
хер	s
продукция	s
эмоция	s
элемент	s
электрокардиограмма	s
электричка	s
электричество	s
экскурсия	s
экран	s
экономист	s
экономика	s
экзамен	s
черта	s
щи	s
щетка	s
щенок	s
ряд	s
ролик	s
розетка	s
роза	s
рубль	s
свеча	s
светофор	s
свет	s
свекровь	s
свекла	s
свадьба	s
сборник	s
сборка	s
сахар	s
сауна	s
сарай	s
роль	s
сапог	s
сантиметр	s
санаторий	s
самолет	s
самокат	s
салон	s
салатик	s
салат	s
сайт	s
садик	s
сад	s
сапожок	s
реклама	s
река	s
результат	s
ручка	s
художник	s
продукт	s
продолжение	s
продажа	s
продавец	s
прогулка	s
прогресс	s
программа	s
проволока	s
провод	s
проект	s
рюмка	s
рынок	s
рыбка	s
рыба	s
..уй	s
русский	s
руль	s
рулон	s
руководитель	s
рукав	s
рука	s
рапорт	s
рубашка	s
рояль	s
роуминг	s
рот	s
рост	s
романтик	s
роман	s
цех	s
ректор	s
речь	s
речка	s
рецепт	s
рецензия	s
реферат	s
ресторан	s
реплика	s
репетиция	s
репертуар	s
ремонт	s
ремень	s
решение	s
цирк	s
цивилизация	s
резерв	s
церковь	s
цепь	s
цепочка	s
центр	s
цена	s
цель	s
целое	s
цветочек	s
студентка	s
цвет	s
царь	s
хулиган	s
..уйня	s
резина	s
рог	s
режиссер	s
режим	s
редиска	s
редактор	s
регистрация	s
регион	s
рожденье	s
ребятишки	s
ребята	s
ребеночек	s
ребенок	s
реал	s
реакция	s
расчет	s
рассказ	s
расстояние	s
рисунок	s
род	s
родина	s
родитель	s
родные	s
родня	s
родственник	s
родственница	s
рожа	s
рождение	s
революция	s
раса	s
расписание	s
пугаться	v
пугать	v
поцеловать	v
починить	v
путать	v
разделить	v
раздеваться	v
раздаваться	v
раздавать	v
потрясать	v
ломать	v
похудеть	v
похоронить	v
походить	v
потянуть	v
лить	v
потрясти	v
пускать	v
пустить	v
кончиться	v
путаться	v
прослушать	v
разбить	v
просмотреть	v
проснуться	v
развестись	v
клясться	v
радовать	v
радоваться	v
ложиться	v
посчитать	v
разбирать	v
разбираться	v
разговаривать	v
разбудить	v
развернуться	v
клеить	v
развести	v
ложить	v
класть	v
развиваться	v
разводить	v
разворачиваться	v
разглядывать	v
купаться	v
принимать	v
приносить	v
прекратить	v
лазить	v
принять	v
кричать	v
приобрести	v
припереться	v
присаживаться	v
присесть	v
прислать	v
преследовать	v
привезти	v
привести	v
кусать	v
прибежать	v
прибегать	v
привлекать	v
приводить	v
курить	v
привозить	v
купить	v
приехать	v
пытаться	v
потеряться	v
потерять	v
потерпеть	v
потащить	v
работать	v
ловить	v
посылать	v
принести	v
преподавать	v
потратить	v
признать	v
прийти	v
прийтись	v
приказать	v
прикалываться	v
прикинуть	v
крутиться	v
крутить	v
прилететь	v
принадлежать	v
подружиться	v
создавать	v
создаваться	v
создать	v
подсказать	v
дружить	v
сойти	v
сойтись	v
мочь	v
положить	v
драться	v
драть	v
думать	v
сомневаться	v
дочитать	v
доходить	v
достигнуть	v
достаться	v
достать	v
соображать	v
сообразить	v
комментировать	v
простить	v
подняться	v
допустить	v
подписать	v
допить	v
сосать	v
подойти	v
подозревать	v
доставать	v
соскучиться	v
подогреть	v
подобрать	v
лечить	v
составить	v
составлять	v
мучаться	v
поднять	v
мучить	v
мучиться	v
сохранить	v
мужать	v
созваниваться	v
созвониться	v
пролететь	v
пропадать	v
кончить	v
кончаться	v
кончать	v
произносить	v
произойти	v
происходить	v
пройти	v
летать	v
контролировать	v
почитать	v
промотать	v
лететь	v
почистить	v
пропасть	v
прописать	v
пропускать	v
пропустить	v
проработать	v
прорваться	v
просидеть	v
проспать	v
простудиться	v
просыпаться	v
лечиться	v
протирать	v
лечь	v
протягивать	v
проучиться	v
появляться	v
появиться	v
проходить	v
просить	v
пошутить	v
прочесть	v
прочитать	v
почувствовать	v
прощать	v
прощаться	v
проявлять	v
прыгать	v
прыгнуть	v
колоть	v
свалиться	v
попасть	v
попадаться	v
знакомиться	v
сбежать	v
сбить	v
значить	v
получиться	v
сбросить	v
получить	v
знать	v
свалить	v
попасться	v
сварить	v
получаться	v
менять	v
сбегать	v
свернуть	v
свести	v
меняться	v
светить	v
получать	v
мерзнуть	v
интересоваться	v
поражаться	v
поработать	v
решать	v
искать	v
решаться	v
решить	v
решиться	v
ржать	v
рисковать	v
рисовать	v
мерить	v
интересовать	v
издеваться	v
попрощаться	v
попросить	v
попробовать	v
поправиться	v
родить	v
родиться	v
попить	v
попереться	v
постоять	v
померить	v
помереть	v
поменяться	v
поменять	v
помазать	v
полюбить	v
пользоваться	v
расписать	v
качаться	v
качать	v
поместиться	v
постирать	v
катиться	v
постараться	v
кататься	v
катать	v
ранить	v
раскрыть	v
распечатать	v
касаться	v
построить	v
помочь	v
мести	v
зевать	v
поломать	v
здравствовать	v
сажать	v
махнуть	v
издавать	v
извиняться	v
извиниться	v
извинить	v
попытаться	v
маяться	v
избавиться	v
идти	v
помогать	v
помнить	v
садиться	v
поразить	v
играть	v
помещаться	v
помешать	v
копить	v
продать	v
продлить	v
продолжать	v
продолжаться	v
предположить	v
продолжить	v
кормить	v
предлагать	v
проезжать	v
проехать	v
прожить	v
лезть	v
проиграть	v
копать	v
произвести	v
производить	v
пришить	v
приставать	v
пристать	v
предъявлять	v
присутствовать	v
присылать	v
придумать	v
привыкнуть	v
присниться	v
купать	v
кушать	v
привязать	v
пригласить	v
приглашать	v
прибавить	v
пригодиться	v
приготовить	v
притащить	v
придумывать	v
приезжать	v
предложить	v
проголодаться	v
предполагать	v
прогуляться	v
продавать	v
продаваться	v
косить	v
лежать	v
изучить	v
понять	v
понравиться	v
понимать	v
рубить	v
имитировать	v
иметься	v
иметь	v
понести	v
ругать	v
рожать	v
пообедать	v
изучать	v
материться	v
понадобиться	v
изобразить	v
помыться	v
изображать	v
измениться	v
изменить	v
помыть	v
махать	v
пробовать	v
приходить	v
приходиться	v
предупреждать	v
предупредить	v
краситься	v
красить	v
раздражать	v
представлять	v
пробить	v
представить	v
привыкать	v
провалиться	v
проверить	v
проверять	v
провести	v
проводить	v
проводиться	v
провожать	v
ругаться	v
попадать	v
пообщаться	v
запомнить	v
заслужить	v
полить	v
заходить	v
зарезать	v
мешать	v
заработать	v
зарабатывать	v
запустить	v
ползти	v
запрещать	v
запретить	v
заснуть	v
запоминать	v
заполнять	v
сдать	v
сводить	v
здороваться	v
связать	v
связаться	v
звякнуть	v
звучать	v
связываться	v
следить	v
познакомиться	v
познакомить	v
скрывать	v
скрыться	v
скучать	v
поздравлять	v
жрать	v
поздравить	v
жить	v
поздороваться	v
звонить	v
мечтать	v
захватить	v
затормозить	v
засыпать	v
засчитать	v
засунуть	v
застрять	v
застать	v
заставлять	v
заставить	v
закрывать	v
заменить	v
заложить	v
залить	v
заливать	v
залезть	v
залезать	v
поклясться	v
покрасить	v
закрыть	v
покататься	v
закрываться	v
заменять	v
закроить	v
закричать	v
закопать	v
закончиться	v
закончить	v
сидеть	v
заколебаться	v
занять	v
заплатить	v
заплакать	v
защитить	v
сгонять	v
сгореть	v
сдавать	v
звать	v
заполнить	v
сдаться	v
сделать	v
защищаться	v
защищать	v
защититься	v
заключаться	v
сдохнуть	v
зашить	v
зашибиться	v
захотеться	v
захотеть	v
закрыться	v
покормить	v
сжечь	v
заметить	v
замерзнуть	v
заинтересовать	v
заварить	v
заваривать	v
завалиться	v
задумываться	v
заканчиваться	v
заканчивать	v
заказывать	v
заказать	v
покатать	v
показывать	v
зайти	v
поить	v
зажигать	v
зажать	v
заехать	v
за..баться	v
завалить	v
задуматься	v
показаться	v
показать	v
задержаться	v
задержать	v
скачать	v
заговорить	v
заводить	v
загнуться	v
заглянуть	v
заглядывать	v
пойти	v
завязывать	v
завязать	v
сканировать	v
завтракать	v
сказать	v
поймать	v
заворачивать	v
загорать	v
скидывать	v
скинуть	v
зависеть	v
завидовать	v
завестись	v
завести	v
завернуть	v
забывать	v
пожрать	v
пожить	v
случиться	v
желать	v
слушать	v
слушаться	v
жевать	v
слышать	v
поиграть	v
забыть	v
служить	v
забрать	v
складывать	v
заболеть	v
заблудиться	v
забить	v
забирать	v
забивать	v
забегать	v
складываться	v
поискать	v
жечь	v
задать	v
задавить	v
задавать	v
скакать	v
загореться	v
женить	v
позвонить	v
слетать	v
позволять	v
слить	v
полететь	v
позволить	v
позвать	v
сложить	v
сложиться	v
позаниматься	v
позавтракать	v
жениться	v
следовать	v
сломать	v
сломаться	v
сниматься	v
срывать	v
ссориться	v
дернуть	v
держаться	v
держать	v
ставить	v
ставиться	v
подготовить	v
подвинуться	v
дергаться	v
собрать	v
подготовиться	v
сниться	v
сносить	v
снять	v
сняться	v
подъехать	v
собирать	v
..бать	v
собираться	v
соблюдать	v
дышать	v
спросить	v
подавать	v
наделать	v
надеть	v
надеяться	v
погулять	v
погодить	v
стереть	v
срезать	v
наблюдать	v
спрашивать	v
подъезжать	v
спрятать	v
спускаться	v
спуститься	v
сработать	v
деться	v
поддержать	v
сравнивать	v
сравнить	v
набрать	v
доказывать	v
поехать	v
жаловаться	v
пожарить	v
жалеть	v
подстричь	v
смотреть	v
ехать	v
есть	v
смотреться	v
смочь	v
пожалеть	v
сметь	v
снести	v
поесть	v
снимать	v
езжать	v
подождать	v
досмотреть	v
подписывать	v
сообщить	v
соответствовать	v
сопротивляться	v
мотаться	v
ездить	v
собраться	v
подчеркивать	v
подходить	v
советовать	v
подумать	v
согласиться	v
дуть	v
соглашаться	v
подтвердить	v
надевать	v
содержать	v
смеяться	v
ждать	v
жать	v
сменить	v
пожениться	v
жарить	v
пожелать	v
молчать	v
сметать	v
поджечь	v
спасти	v
добраться	v
добиться	v
добираться	v
добавлять	v
добавить	v
спать	v
подложить	v
подключить	v
спеть	v
подключать	v
подержать	v
поднимать	v
спешить	v
поделиться	v
поделить	v
поделать	v
подействовать	v
списывать	v
спорить	v
диктовать	v
поддерживать	v
покурить	v
записываться	v
записывать	v
записаться	v
записать	v
полезть	v
полежать	v
полагаться	v
покушать	v
заняться	v
поживать	v
набирать	v
покупать	v
заниматься	v
занимать	v
занести	v
замучить	v
покраситься	v
замочить	v
замолчать	v
сесть	v
замечать	v
делить	v
довести	v
доверять	v
мыться	v
довезти	v
наговорить	v
подвести	v
сталкиваться	v
становиться	v
навести	v
стараться	v
доводить	v
делаться	v
делать	v
навестить	v
подбирать	v
действовать	v
подать	v
дергать	v
дежурить	v
подарить	v
стать	v
доесть	v
набить	v
подниматься	v
доказать	v
сохраниться	v
дойти	v
доить	v
дожить	v
сохранять	v
дождаться	v
доехать	v
сорвать	v
доедать	v
договориться	v
договорить	v
справиться	v
договариваться	v
догнать	v
догадываться	v
догадаться	v
сочинять	v
мыть	v
начинаться	v
опустить	v
глотать	v
терпеть	v
опускать	v
гнать	v
начать	v
определиться	v
гладить	v
начаться	v
терять	v
начинать	v
отвести	v
определить	v
платить	v
остынуть	v
гореть	v
наступить	v
остановиться	v
насыпать	v
организовать	v
гонять	v
остаться	v
нарвать	v
считать	v
считаться	v
сшибить	v
сшить	v
съедать	v
твориться	v
съездить	v
греть	v
съесть	v
сыграть	v
голосовать	v
сыпать	v
нарезать	v
нарисовать	v
побывать	v
определять	v
встретить	v
глядеть	v
глючить	v
тереть	v
плевать	v
накрывать	v
накладывать	v
назначить	v
дать	v
накопить	v
дарить	v
стрелять	v
стремиться	v
освободиться	v
накормить	v
стричь	v
накачать	v
стоить	v
стесняться	v
надоедать	v
стирать	v
надоесть	v
деваться	v
девать	v
поговорить	v
поглядеть	v
надумать	v
находиться	v
натянуть	v
орать	v
поверить	v
научить	v
научиться	v
отвезти	v
годиться	v
находить	v
говориться	v
говорить	v
напрягать	v
гнить	v
повысить	v
стоять	v
двигаться	v
называть	v
страдать	v
называться	v
найти	v
найтись	v
повышать	v
отрезать	v
отправлять	v
пахнуть	v
пахать	v
варить	v
отпускать	v
отпустить	v
отработать	v
отреагировать	v
беречь	v
валяться	v
чесать	v
валять	v
бесить	v
беситься	v
отремонтировать	v
носить	v
носиться	v
беспокоить	v
быть	v
париться	v
оторвать	v
читать	v
отобрать	v
вешать	v
взяться	v
взять	v
переводить	v
одеть	v
услышать	v
вздыхать	v
уснуть	v
успевать	v
успеть	v
отомстить	v
чихать	v
перевестись	v
успокоиться	v
уставать	v
устанавливать	v
установить	v
перевести	v
устать	v
устраивать	v
устраиваться	v
таскать	v
нарушать	v
побежать	v
победить	v
останавливать	v
побегать	v
танцевать	v
готовиться	v
останавливаться	v
настроить	v
плюнуть	v
побить	v
остановить	v
наступать	v
тащить	v
тащиться	v
творить	v
напугать	v
сходить	v
повезти	v
являться	v
побыть	v
учиться	v
чистить	v
одеваться	v
бежать	v
велеть	v
учесть	v
везти	v
одевать	v
переставить	v
учитывать	v
учить	v
наесться	v
оторваться	v
отправить	v
отправиться	v
вводить	v
ввести	v
чесаться	v
плясать	v
готовить	v
побояться	v
поболтать	v
выиграть	v
вылазить	v
выкупить	v
выбирать	v
выключить	v
выключать	v
выкладывать	v
выкинуть	v
встретиться	v
выйти	v
выбрасывать	v
выигрывать	v
вылезать	v
выбрать	v
выбраться	v
выбросить	v
вызывать	v
топить	v
печатать	v
пилить	v
выяснить	v
выясниться	v
выяснять	v
печь	v
выдвинуть	v
арестовать	v
вызвать	v
выжить	v
выехать	v
вывести	v
выезжать	v
выдержать	v
выделяться	v
выделять	v
экономить	v
выдвигать	v
выдать	v
выдавать	v
выгонять	v
отдохнуть	v
выгнать	v
выводить	v
выглядеть	v
выкидывать	v
выбивать	v
плакать	v
ответить	v
выступать	v
опоздать	v
встречать	v
шутить	v
выступить	v
отдавать	v
отвлекаться	v
требоваться	v
вытаскивать	v
торчать	v
вытащить	v
вытереть	v
встречаться	v
плавать	v
вытянуть	v
выучить	v
торопиться	v
вступить	v
выходить	v
тормозить	v
оплачивать	v
течь	v
отвлекать	v
пить	v
питаться	v
вязать	v
торговать	v
петь	v
выставить	v
топать	v
отдыхать	v
выпускать	v
описать	v
описывать	v
отвечать	v
оплатить	v
писаться	v
писать	v
толкать	v
толкаться	v
трепаться	v
трогать	v
накрыть	v
напоминать	v
напомнить	v
направить	v
грузиться	v
грузить	v
повернуть	v
существовать	v
сфотографировать	v
схватить	v
наложить	v
строиться	v
нанять	v
наладить	v
повторяться	v
наливать	v
налить	v
повторять	v
повторить	v
освободить	v
глянуть	v
стучать	v
давить	v
повернуться	v
строить	v
нажать	v
нажимать	v
нажраться	v
погладить	v
оставаться	v
столкнуться	v
названивать	v
погибнуть	v
назвать	v
даваться	v
повести	v
гулять	v
суметь	v
напечатать	v
написать	v
повесить	v
сунуть	v
напиться	v
наплевать	v
грызть	v
выслать	v
вылить	v
вылечить	v
вылететь	v
вырвать	v
выспаться	v
высохнуть	v
шуметь	v
входить	v
требовать	v
выслушивать	v
выложить	v
выскакивать	v
вырезать	v
вылезти	v
вырасти	v
отдать	v
выражаться	v
выпустить	v
тратить	v
опаздывать	v
травить	v
выплатить	v
давать	v
оставить	v
поворачивать	v
оставлять	v
судить	v
нанимать	v
выпасть	v
выполнить	v
въехать	v
выплевывать	v
верить	v
выпить	v
выписывать	v
выписать	v
выпивать	v
планировать	v
выполнять	v
вынуть	v
вынимать	v
вынести	v
вымыть	v
удовлетворить	v
возиться	v
открыться	v
возить	v
отличаться	v
удивиться	v
улететь	v
возвращать	v
переносить	v
удивляться	v
воевать	v
отличить	v
удивить	v
перенести	v
уезжать	v
водить	v
употреблять	v
отнять	v
унести	v
передумать	v
передергивать	v
висеть	v
переделывать	v
вносить	v
отнести	v
ужинать	v
перейти	v
узнавать	v
узнать	v
уйти	v
уехать	v
указывать	v
укладывать	v
укладываться	v
упаковать	v
перезвонить	v
украсть	v
нести	v
нестись	v
укусить	v
возвращаться	v
возмущаться	v
ударить	v
удаться	v
нервничать	v
включить	v
влюбиться	v
влиять	v
открыть	v
влезть	v
переезжать	v
владеть	v
относиться	v
умолять	v
умываться	v
умыться	v
уметь	v
включать	v
откроить	v
врать	v
перестать	v
тусоваться	v
отключить	v
оказываться	v
тушить	v
впаривать	v
шить	v
видеть	v
переделать	v
упасть	v
упираться	v
вкладывать	v
чувствоваться	v
чувствовать	v
передать	v
передавать	v
переговорить	v
видеться	v
отмечать	v
одеться	v
видать	v
умирать	v
чуять	v
пережить	v
уложить	v
улыбаться	v
переживать	v
переехать	v
умереть	v
разрешить	v
разогреть	v
расстроиться	v
кидать	v
кивать	v
разойтись	v
разорвать	v
разориться	v
разрезать	v
разрешать	v
кашлять	v
лопнуть	v
разобраться	v
поступать	v
порезать	v
резать	v
мазать	v
посадить	v
поругаться	v
рекламировать	v
рекомендовать	v
портиться	v
исчезнуть	v
кидаться	v
распустить	v
поставить	v
рассказать	v
рассказывать	v
расслабиться	v
рассматривать	v
рассмотреть	v
расстаться	v
расстегнуть	v
расстраиваться	v
исчезать	v
разливать	v
кипятить	v
кипеть	v
различать	v
кинуть	v
разложить	v
разменять	v
ломаться	v
поступить	v
разобрать	v
реветь	v
поссориться	v
рвануть	v
рвать	v
рваться	v
реагировать	v
списать	v
любить	v
посоветоваться	v
посоветовать	v
посмотреть	v
расти	v
казаться	v
послушать	v
послать	v
посидеть	v
посещать	v
поселиться	v
указать	v
отложить	v
отменить	v
отметить	v
использовать	v
портить	v
ремонтировать	v
поржать	v
посвятить	v
испытывать	v
испугаться	v
исправлять	v
исправить	v
испортиться	v
испортить	v
тыкать	v
исполнять	v
исполниться	v
порвать	v
испечь	v
поспать	v
рассуждать	v
рассчитать	v
рассчитывать	v
растаять	v
растеряться	v
обращать	v
фотографироваться	v
обедать	v
обещать	v
отъехать	v
оформить	v
образоваться	v
обратить	v
обратиться	v
оценивать	v
охренеть	v
цвести	v
фотографировать	v
обходить	v
обращаться	v
обрезать	v
худеть	v
целовать	v
целоваться	v
обрывать	v
охранять	v
оформлять	v
обсуждать	v
нравиться	v
обмануть	v
падать	v
обнаглеть	v
обнаружить	v
обниматься	v
бить	v
парить	v
беспокоиться	v
отсканировать	v
бывать	v
ценить	v
отстать	v
объяснять	v
бухать	v
объяснить	v
объехать	v
хлопать	v
биться	v
объесться	v
обалдеть	v
отходить	v
перебить	v
оценить	v
вертеться	v
устроиться	v
вести	v
перевернуть	v
весить	v
уступать	v
утилизировать	v
веселиться	v
уточнить	v
храниться	v
перебирать	v
устроить	v
ухаживать	v
перебивать	v
бегать	v
вернуться	v
вернуть	v
отойти	v
уходить	v
участвовать	v
ошибаться	v
обсудить	v
цепляться	v
хотеть	v
ощущать	v
ходить	v
обожать	v
обозначать	v
блестеть	v
обойти	v
обойтись	v
офигеть	v
обрадоваться	v
хоронить	v
ночевать	v
хотеться	v
общаться	v
цитировать	v
болтаться	v
болтать	v
хохотать	v
болеть	v
уволить	v
воспринимать	v
ненавидеть	v
ассоциироваться	v
отказаться	v
перечислять	v
отказываться	v
переходить	v
трястись	v
откладывать	v
отключать	v
переодеваться	v
тронуть	v
вонять	v
угадать	v
угнать	v
уговаривать	v
уговорить	v
шастать	v
волноваться	v
волновать	v
угодить	v
увлекаться	v
восстановить	v
оказаться	v
переть	v
открывать	v
перепутать	v
переписываться	v
тянуть	v
тянуться	v
открываться	v
убегать	v
убежать	v
угорать	v
шляться	v
встать	v
вставлять	v
вставить	v
вставать	v
вспомнить	v
вспоминаться	v
вспоминать	v
вскочить	v
отказать	v
бросать	v
воровать	v
увеличить	v
ожидать	v
одолжить	v
увидеть	v
увидеться	v
хвалить	v
обидеть	v
обидеться	v
бросить	v
увеличивать	v
бродить	v
обижать	v
обижаться	v
обладать	v
браться	v
брать	v
будить	v
хватать	v
хватить	v
бояться	v
воспитать	v
угостить	v
угощать	v
войти	v
удалить	v
переночевать	v
возражать	v
возникнуть	v
возникать	v
ворчать	v
убивать	v
расписаться	v
переписывать	v
убирать	v
убираться	v
убить	v
переписать	v
убрать	v
убраться	v
уронить	v
уважать	v
увезти	v
